12
XXXXXXXXXXXX
XXXXXXXXXXXX
XXXXXXXXXXXX
XXFFFXXXXXXX
FFFFFFFFXXXX
XXFFFFFFFFFX
XXXFFFFFFFFF
XXXXXXXFFWFF
XXXXXXXXFFFX
XXXXXXXXXXXX
XXXXXXXXXXXX
XXXXXXXXXXXX
3 4
9 7
007