6
XFFFFX
XFFFFX
XXXFXX
XXXFXX
XFFFXX
XFFWXX
3 0
3 5
008