8
XXXXFFXX
XXXXFFFX
XXXXFFFF
XXXXFFXX
FFFFFFXX
FWFFFXXX
FFFXXXXX
XXXXXXXX
5 2
1 5
005